12 10
**********
*      * *
* *  *@* *
* *  * * *
**   *** *
*  ***   *
*     ****
**** * ***
* *    * *
* * ** * *
*   **   *
******#***
